# Syntax Colouring Map for runningAngle


# Data types (KEYWORD1)
runningAngle	KEYWORD1
AngleType	KEYWORD1


# Methods and Functions (KEYWORD2)
add	KEYWORD2
reset	KEYWORD2
getAverage	KEYWORD2

setWeight KEYWORD2
getWeight	KEYWORD2

type	KEYWORD2
wrap	KEYWORD2

setMode0	KEYWORD2
getMode1	KEYWORD2


# Constants (LITERAL1)
RUNNING_ANGLE_LIB_VERSION	LITERAL1

DEGREES	LITERAL1
RADIANS	LITERAL1
GRADIANS	LITERAL1

DEFAULT_WEIGHT	LITERAL1
